1,2,2,2,2,2,2,2,3,
4,9,9,9,9,9,9,9,5,
4,9,0,0,0,0,0,9,5,
4,9,9,9,0,9,9,9,5,
4,9,9,9,0,9,9,9,5,
4,9,9,9,0,9,9,9,5,
4,9,9,9,9,9,9,9,5,
6,7,7,7,7,7,7,7,8,